0 0 0 0 0 0 0 0 0 0 0 0 0 0 0 0
0 0 0 0 0 0 0 0 0 0 0 0 0 0 0 0
0 0 0 0 0 0 0 0 0 0 0 0 0 0 0 0
0 0 0 0 0 0 0 0 0 0 0 0 0 0 0 0
0 0 0 0 0 0 0 0 0 0 0 0 0 0 0 0
0 0 0 0 0 0 0 0 0 0 0 0 0 0 0 0
0 10 10 10 10 10 10 10 10 10 10 10 10 10 10 0
0 10 10 3 10 10 10 3 10 10 10 3 10 10 10 0
0 2 2 2 2 2 2 2 2 2 2 2 2 2 2 0
0 9 9 9 9 9 9 9 9 9 9 9 9 9 9 0
0 2 2 2 2 2 2 2 2 2 2 2 2 2 2 0
0 7 7 7 7 7 7 0 0 7 7 7 7 7 7 0 