0 0 0 0 0 0 1 3 3 1 0 0 0 0 0 0 
0 0 0 0 0 0 1 2 2 1 0 0 0 0 0 0
0 0 0 0 0 0 1 2 2 1 0 0 0 0 0 0
0 0 0 0 0 0 1 2 2 1 0 0 0 0 0 0
0 0 0 0 0 0 1 2 2 1 0 0 0 0 0 0
0 0 0 0 0 0 1 2 2 1 0 0 0 0 0 0
0 0 0 0 0 0 1 2 2 1 0 0 0 0 0 0
0 0 0 0 0 0 1 2 2 1 0 0 0 0 0 0
0 0 0 0 0 0 1 2 2 1 0 0 0 0 0 0
0 0 0 0 0 0 1 2 2 1 0 0 0 0 0 0
0 0 0 0 0 0 1 2 2 1 0 0 0 0 0 0
0 0 0 0 0 0 1 3 3 1 0 0 0 0 0 0 