1 1 1 1 1 1 1 3 3 1 1 1 1 1 1 1
4 5 5 5 5 5 5 5 5 5 5 5 5 5 5 4
4 5 17 5 5 5 5 5 5 5 5 16 5 5 5 4
4 5 5 5 5 5 5 5 5 5 5 5 5 5 5 4
4 5 5 5 5 5 5 5 5 5 5 5 5 17 5 4
4 5 5 5 5 16 5 5 5 5 5 5 5 5 5 4
4 5 5 5 5 5 5 5 5 5 5 5 5 5 5 4
4 5 5 5 5 5 5 5 5 5 17 5 5 5 5 4
4 5 5 5 5 5 5 5 5 5 5 5 5 5 5 4
4 5 5 17 5 5 5 5 5 5 5 5 5 5 5 4
4 5 5 5 5 5 5 5 5 5 5 5 5 5 5 4
4 4 4 4 4 4 4 4 4 4 4 4 4 4 4 4 