6 6 6 6 6 6 6 6 6 6 6 6 6 6 6 6
21 21 21 21 21 2 2 2 2 2 2 2 2 8 2 2
21 21 21 21 21 2 2 2 2 2 2 2 2 2 2 2
21 21 21 21 21 2 2 2 2 2 2 2 2 2 2 2
18 19 20 19 19 2 2 2 2 2 2 2 2 2 2 2
2 2 2 2 2 2 2 2 2 2 2 2 2 2 2 2
2 2 2 2 2 2 2 2 2 2 2 2 2 2 2 2
2 2 2 2 2 2 2 2 2 2 2 2 2 2 2 2
2 2 2 2 2 2 2 2 2 2 2 2 2 2 2 2
2 2 2 2 2 2 2 2 2 2 2 2 2 2 2 2
2 2 2 2 2 2 2 2 2 2 2 2 2 2 2 2
7 7 7 7 7 7 7 3 3 7 7 7 7 7 7 7